62222229
41111115
41111115
41111115
41111115
73333338
13