62222229
41111115
41f11f15
41f11f15
41111115
73333338
42