62222229
4ff11ff5
4ff11ff5
41111115
4ff11ff5
73333338
13